NO ./textures/north.xpm
SO ./textures/south.xpm
WE ./textures/west.xpm
EA ./textures/east.xpm
F 220,100,0

C 225,30,0



1111111111111111111111111111
10000000S10000001100000010001
11111111111111111111111111111
1  10000000010000001101010010001
11100001110101011111011110011
11110111 1110101 101111010001
11111111 1111111 111111111111