NO ./textures/north.xpm
SO ./textures/south.xpm
WE ./textures/west.xpm
EA ./textures/east.xpm
F 220,100,0,50
C 225,30,0

1111111111111111111111111
1000000000110000000000001
1011000001110000000000001
1001000000000000000000001
1111111110110000011100000001
1000000000110000011101111111
1111011111111101110000001001
1111011111111101110101001001
1100000011010101110000001001
1000000000000000110000001001
1000000000000000110101001001
1100000111010101111101111N011
1111011111110101 10111101001
1111111111111111 11111111111
