NO ./textures/north.xpm
SO ./textures/south.xpm
WE ./textures/west11.xpm
EA ./textures/east.xpm

F 220,100,0
C 225,30,0

11111111111111
100N0001
100000001
111111111
